__########
__#______#
__#_$$$__#
###_#_#_##
#___@_#__#
#___#____#
#_....._.#
##########