####__
#..#__
#__###
#@$__#
#__$_#
#__._#
######